00000000000000000000000000000000000000000000000000000000000000000000000000000000
00000000000000000000000000000000000000000000000000000000000000000000000000000000
00000000000000000000000000000000000000000000000000000000000000000000000000000000
00000000000000000000000000000000000000000000000000000000000000000000000000000000
00000000000000000000000000000000000000000000000000000000000000000000000000000000
00000000000000000000000000000000000000000000000000000000000000000000000000000000
00000000000000000000000000000000000000000000000000000000000000000000000000000000
00000000000000000000000000000000000000000000000000000000000000000000000000000000
00000000000000000000000000000000000000000000000000000000000000000000000000000000
00000000000000000000000000000000000000000000000000000000000000000000000000000000
00000000000000000000000000000000000000000000000000000000000000000000000000000000
00000000000000000000000000000000000000000000000000000000000000000000000000000000
00000000000000000000000000000000000000000000000000000000000000000000000000000000
00000000001111111111111000000000000044444444444444444000000000000000000000000000
00000000001111111111111000000000000044444444444444444000000000000000000000000000
00000000001111111111111000000000000044444444444444444000000000000000000000000000
00000000001111111111111000000000000044444444444444444000000000000000000000000000
00000000001111111111111000000000000044444444444444444000000000000000000000000000
00000000001111111111111000000000000044444444444444444000000000000000000000000000
00000000001111111111111000000000000044444444444444444000000000000000000000000000
00000000001111111111111000000000000044444444444444444333333333333000000000000000
00000000001111111111111000000000000044444444444444444333333333333000000000000000
00000000001111111111111000000000000044444444444444444333333333333000000000000000
00000000001111111111111000000000000044444444444444444333333333333000000000000000
00000000001111111111111000000222222244444444444444444333333333333000000000000000
00000000001111111111111000000222222222222000000000033333333333333000000000000000
00000000001111111111111000000222222222222000000000033333333333333000000000000000
00000000000000000000000000000222222222222000000000033333333333333000000000000000
00000000000000000000000000000222222222222000000000033333333333333000000000000000
00000000000000000000000000000222222222222000000000033333333333333000000000000000
00000000000000000000000000000222222222222000000000033333333333333000000000000000
00000000000000000000000000000222222222222000000000033333333333333000000000000000
00000000000000000000000000000222222222222000000000033333333333333000000000000000
00000000000000000000000000000222222222222000000000000000000000000000000000000000
00000000000000000000000000000222222222222000000000000000000000000000000000000000
00000000000000000000000000000222222222222000000000000000000000000000000000000000
00000000000000000000000000000222222222222000000000000000000000000000000000000000
00000000000000000000000000000000000000000000000000000000000000000000000000000000
00000000000000000000000000000000000000000000000000000000000000000000000000000000
00000000000000000000000000000000000000000000000000000000000000000000000000000000
00000000000000000000000000000000000000000000000000000000000000000000000000000000
00000000000000000000000000000000000000000000000000000000000000000000000000000000
00000000000000000000000000000000000000000000000000000000000000000000000000000000
00000000000000000000000000000000000000000000000000000000000000000000000000000000
00000000000000000000000000000000000000000000000000000000000000000000000000000000
00000000000000000000000000000000000000000000000000000000000000000000000000000000
00000000000000000000000000000000000000000000000000000000000000000000000000000000
00000000000000000000000000000000000000000000000000000000000000000000000000000000
00000000000000000000000000000000000000000000000000000000000000000000000000000000
00000000000000000000000000000000000000000000000000000000000000000000000000000000
