00000000000000000000000000000000000000000000000000000000000000000000000000000000
00000000000000000000000000000000000000000000000000000000000000000000000000000000
00000000000000000000000000000000000000000000000000000000000000000000000000000000
00000000000000000000000000000000000000000000000000000000000000000000000000000000
00000000000000000000000000000000000000000000000000000000000000000000000000000000
00000000000000000000000000000000000000000000000000000000000000000000000000000000
00000000000000000000000000000000000000000000000000000000000000000000000000000000
01111100000000000000000000000000000000000000000000000000000000000000000000000000
01111100000000000000000000000000000000000000000000000000000000000000000000000000
01111100000000000000000000000000000000000000000000000000000000022222200000000000
01111100000000000000000000000000022222220000000000000000000000022222200000000000
01111100000000044444444444444444422222220000000000000000000000022222200000000000
00000000000000044444444444444444422222220000000000000000000000022222200000000000
00000000000000044444444444444444422222220000000000000000000000022222200000000000
00000000002222244444444444444444422222220000000000000000000000022222200000000000
11111111112222220000000000000000022222220000000000000000000000000000000000000000
11111111112222220000000000000000022222220000000000000000000000000000000000000000
00000000002222220000000000000000000000000000000000000000000000000000000000000000
00000000002222220000000000000000000000000000000000000000000000000000000000000000
00000000000000000000000000000000000000000000000000000000000000000000000000000000
00000000000000000000000000000000000000000000000000000000000000000000000000000000
00000000000000000000000000000000000000000000000022222220000000000000000000000000
00000000000000000000022222220000000000000000000022222220000000000000000000000000
00000000000000000000022222220000000000000000000022222211111111111111111111111110
11111111111111111111122222220000000000000000000022222211111111111111111111111110
11111111111111111111122222220000000000000000000022222211111111111111111111111110
11111111111111111111122222220000000000000000000022222220000000000000000000000000
00000000000000000000022222220000000000000000000022222220000000000000000000000000
00000000000000000000000000000000000000000000000000000000000000000222222200000000
00000000000000000000000000000000022222220000000000000000000000000222222200000000
00000000000000000000000000000000022222220000000000000000000000000222222200000000
44444444444444444444444444444444422222220000000000000000000000000222222200000000
44444444444444444444444444444444422222220000000000000000000000000222222200000000
44444444444444444444444444444444422222220000000000000000000000000222222200000000
44444444444444444444444444444444422222220000000000000000000000000000000000000000
00022222222000000000000000000000022222220000000000000444444444444444444444444444
00022222222000000000000000000000000000000000002222222444444444444444444444444444
00022222222000000000000000000000000000000000002222222444444444444444444444444444
00022222222000000000000000000000000000000000002222222444444444444444444444444444
00022222222000000000000000000000000000000000002222222444444444444444444444444444
44422222222444444444442222222000000000000000002222222000000000000000000000000000
00000000000000000000002222222000000000000000002222222000000000222222220000000000
00000000000000000000002222222000000000000000000000000000000000222222220000000000
00000000000000000000002222222000000000000000000000000000000000222222220000000000
00000000000000000000002222222000000000000000000000000000000000222222220000000000
00000000000000000000002222222000000000000000000000000000000000222222220000000000
00000000000000000000000000000000000000033333000000000000000000222222220000000000
00000000000000000000000000000000000000033333000000000000000000000000000000000000
00000000000000000000000000000000000000033333000000000000000000000000000000000000
00000000000000000000000000000000000000033333000000000000000000000000000000000000
