00000000000000000000000000000000000000000000000000000000000000000000000000000000
00000000000000000000000000000000000000000000000000000000000000000000000000000000
00000000000000000000000000000002220000000000000000000000000000000000000000000000
00000000000000000000000000000002220000000000000000000000000000000000000000000000
00000000000000000000000000000002220000000000000000000000000000000000000000000000
00000000000000000000000000000002220000000000000000000000000000000000000000000000
00000000000000000000000000000002220000000000000000000220000220000000000000000000
00000000000002200000000000000002220000000000000000000220000220000000000000000000
00000000000002200000000000000002220000000000000000000220000220000000000000000000
00000000000002200000000000000002220000002200000000000220000220000000000000000000
00000000000002200000000000000002220000002200000000000220000220000000000000000000
00000000000002200000000000000002220000002200000000000220000220000000000000000000
00000000000002200000000000000002220000002200000000000220000220000000000000000000
22200000000002200000222222200002220000002200000000000220000220000000000000000000
22200000000002200000200000200002220000002200000000000220000220000000000000000000
22200000000002200000200022200002220000002200000000000220000220000000000000000000
22200000000002200000200020000002220000002200000000000220000220000000000000000000
22200000000002200000222220000002220000002200000000000220000220000000000000000000
22200000000002200000200020000002220000002200000000000220000220000000000000000000
22200000000002200000200020000002220000002200000000000220000220000000000000000000
22200000000002200000200020000002220000002200000000000221111220000000000000000000
22200000000002200000200020000002220000002200000000000221111220000000000000000000
22200000000002200000200020000002220000002200000000000221111000000000000000000000
22200000000002200000200020000002220000000000000000000220000000000000000000000000
22200000000002200000200021111111221111110000000000000220000000000000000000000000
22200000000002200000200021100001001111110000000000000220000000000000000000000000
22200000000002000000200021100001001111110000000000000220000000000000000000000000
22200000000000000000200021111111001111110000000000000220000000000000000000000000
22200000220000000000200021111111111111110000000000000220000000222000000000000000
22200000220000000000200020000000000000222222222220000220000000222000000000000000
22200000220000000000200020000000000000222222222220000220000000222000000000000000
22200000220000000000200020000000000000000000000000000220000000222000000000000000
22200000220000000000200020000000000000000000000000000220000000222000000000000000
22200000220000000000222220000000000000000000000000000220000000222000000000000000
22200000220000000000000000000000000000000000000000000220000000222000000000000000
22200000220000000000000000000000000000000000000000000220000000222000000000000000
00000000220000000000000000000000000000000000000000000220000000222000000000000000
00000000220000000000000000022220000000000000000000000220000000222000000000000000
00000000220000000000000000022220000000000000000000000220000000222000000000000000
00000000220000000000000000022220000000000000000000000220000000222000000000000000
00000000220000000000000000022220000000000000000000000000000000222000000000000000
00000000220000000000000000022220000000000000000000000000000000222000000000000000
00000000220000000000000000022220000000000000000000000000000000222000000000000000
00000000000000000000000000022220000000000000000000000000000000000000000000000000
00000000000000000000000000022220000000000000000000000000000000000000000000000000
00000000000000000000000000022220000000000000000000000000000000000000000000000000
00000000000000000000000000022220000000022222000000000000000000000000000000000000
00000000000000000000000000000000000000020002000000000000000000000000000000000000
00000000000000000000000000000000000000020002000000000000000000000000000000000000
00000000000000000000000000000000000000020002000000000000000000000000000000000000
