02222000000000000000000000000000000000022222222222222222222222222222222222224000
02222000000000000000000000000000000000022222222222222222222222222222222222224000
02200000000000000000000000000000000000000000000000000000000000000000000000004000
02200000000000000000000000000000000000000000000000000000000000000000000000004000
02200000000000003333333333333333333330000000000000000000000000000000000330004000
02200000000000003333333333333333333330000000000000000000000000000000000330004000
02200000000000000000000000000000000000000000000000000000000000000000000330004000
02200000000000000000000000000000000000000000000000000000000000000000000330004000
02200000000000000000000000000000000000000000000000000000000000000000000330004000
02200000000000000222000000000000000000000000000000000000000000000000000330004000
02200000000000000222000000000000000000000000000000000000000000000000000330004000
02200000000000000222000000000000000000000000000000000000000022000000000330004000
02200000000000000222000000000000440000000000000000000000000022000000000330004000
00000000000000000222000000000000440000000000000000000000000022000000000330004000
00000000000000000222000000000000440000000000000000000000000022000000000330004000
00222222222222222222000000000000440000000000000000000000000022000000000330004000
00222222222222222222000000000000440000000000000000000000000022000000000330004000
00222222222222222222000000000000440000000000000000000000000022000000000330004000
00000000000000000000000000000000440000000000000000000000000022000000000330004000
00000000000000000000000000000000440000000000000000000000000022000000000000004000
00000000000000000000000000000000440000000000000000000000000022000000000000004000
00000000000000000000000000000000440000000000000000000000000022000000000000004000
00000000000000000000000000001100444444444444400000000000000022000000000000004000
00000000000000000000000000001100444444444444400000000000000022000111111111114000
00000000000000000000000000001100444000000000000000000000000022000111111111114000
00000000000000000000000000001100444000000000000000000000000022000000000000004000
00000000000000000000000000001100000000000000000000000000000022000000000000004000
00000000000000000000000000001100000000000000000000000000000022000000000000004000
11111111111111111111111111111100000000000000000000000000000022000000000000004000
11111111111111111111111111111111100000000000000000000000000022000000000000004000
00000000000000000000110000000111100000000000000000000000000022000000000000004000
00000000000000000000110000000000000000000022222222222222222222222222222200004000
00000000000000000000110000000000000000000022222222222222222222222222222200004000
00000000000000000000110000000000000000000000000000000000000000000000000000004000
00000000000000000000110000000000000000000000000000000000000000000000000000004000
00000000000000000000110000000000000000000000000000000000000000000000000000004000
00000000000000000000110000000000000000000000000000220000044444444444444444444000
00000000000000000000110000000000000000000000000000220000000000000000000000000000
00000000000000000000110000000333333333333333300000220000000000000000000000000000
00000000000000000000110000000000000000000000300000220000000000000000000000000000
00000000000000000000222200000000000000000000300000220000000000000000000000000000
00000000000000000000222200000000000000000000300000220000000000000000000000000000
00000000000000000000222200000000000000000000300000220000000000000000000000000000
22222222222222222222222200000000000000000000000000220000000000000000000000000000
22222222222222222222222200000000000000000000000000222222222222222222220000000000
00000000000000000000000000000000000000000000000000222222222222222222220000000000
00000000000000000000000000000000000000000000000000000000000000000000000000000000
00000000000000000000000000000000000000000000000000000000000000000000000000000000
00000000000000000000000000000000000000000000000000000000000000000000000000000000
00000000000000000000000000000000000000000000000000000000000000000000000000000000
