00000000000000000000000000000000000000000000000000000000000000000000000000000000
00000000000000000000000000000000000000000000000000000000000000000000000000000000
00000000000000000000000000000000000000000000000000000000000000000000000000000000
00000000000000000000000000000000000000000000000000000000000000000000000000000000
00000000000000000000000000000000000000000000000000000000000000000000000000000000
00000000000000000000000000000000000000000000000000000000000000000000000000000000
00000000000000000000000000000000000000000000000000000000000000000000000000000000
00000000000000000000000000000000000000000000000000000000000000000000000000000000
00000111111111111100000000000000000000000000000000000000000000000000000000000000
00000111111111111100000000000000000000000000000000000000000000000000000000000000
00000111111111111100000000000000000000000000000000000000000000000000000000000000
00000111111111111100000000000000000000000000000000000000000000000000000000000000
00000111111111111100000000000000000000000000000000000000000000000000000000000000
00000111111111111100000000000000000111111000000000000000000000000000000000000000
00000111111111111100000000000000000111111000000000000000000000000000000000000000
00000111111111111100001111111000000111111000000000000000000000000000000000000000
00000111111111111100001111111000000111111000000000000000000000000000000000000000
00000111111111111100001111111000000111111000000000000000000000000000000000000000
00000111111111111100001111111000000111111000000000000044444444440000000000000000
00000111111111111100001111111000000111111000000000000044444444440000000000000000
00000111111111111100001111111000000111111000000000000044444444440000000000000000
00000111111111111100001111111000000111111000000000000044444444440000000000000000
00000111111111111100000000000000000111111000000000000044444444440000000000000000
00000000000000000000000000000000000000000000000000000044444444440000000000000000
00000000000000000000000000000000000000000000000000000044444444440000000000000000
00000000000000000000000000000000000000000000000000000044444444440000000000000000
00000000000000000000000000000000000000000000000000000044444444440000000000000000
00000000000000000000000000000000000000000000000000000000000000000000000000000000
00000000000000000000000000000000000000000000000000000000000000000000000000000000
00000000000000000000000000000000000000000000000000000000000000000000000000000000
00000000000000000000000000000000000000000000000000000333333333000000000000000000
00000000000000000000000000000000000000000000000000000333333333000000000000000000
00000000000000000000000000000000000000000000000000000333333333000000000000000000
00000000000000000000000000022222222222222000000000000333333333000000000000000000
00000000000000000000000000022222222222222000000000000333333333000000000000000000
00000000000000000000000000022222222222222000000000000333333333000000000000000000
00000000000000000000000000022222222222222000000000000333333333000000000000000000
00000000000000000000000000022222222222222000000000000333333333000000000000000000
00000000000000000000000000022222222222222000000000000333333333000000000000000000
00000000000000000000000000022222222222222000000000000333333333000000000000000000
00000000000000000000000000022222222222222000000000000000000000000000000000000000
00000000000000000000000000022222222222222000000000000000000000000000000000000000
00000000000000000000000000022222222222222000000000000000000000000000000000000000
00000000000000000000000000022222222222222000000000000000000000000000000000000000
00000000000000000000000000000000000000000000000000000000000000000000000000000000
00000000000000000000000000000000000000000000000000000000000000000000000000000000
00000000000000000000000000000000000000000000000000000000000000000000000000000000
00000000000000000000000000000000000000000000000000000000000000000000000000000000
00000000000000000000000000000000000000000000000000000000000000000000000000000000
00000000000000000000000000000000000000000000000000000000000000000000000000000000
