00000000000000000000000000000000000000000000000000000000000000000000000000000000
00000000000000000000000000000000000000000000000000000000000000000000000000000000
00000000000000000000000000000000000000000000000000000000000000000000000000000000
00000000000000000000000000000000000000000000000000000000000000000000000000000000
00000000000000000000000000000000000000000000000000000000000000000000000000000000
00000000000000000000000000000000000000000000000000000000000000000000000000000000
00000000000000000000000000000000000000000000000000000000000000000000000000000000
00000000000000000000000000000000000000000000000000000000000000000000000000000000
00000000000000000000000000000000000000000000000000000000000000000000000000000000
00000000000000000000000000000000000000000000000000000000000000000000000000000000
00000000000000000000000000000000000000000000000000000000000000000000000000000000
00000000000000000000000000000000000000000000000000000000000000000000000000000000
00000000000000000000000000000000000000000000000000000000000000000000000000000000
00022222000200020002220022222000000000000000000000000000000000000000000000000000
00020000000200020000200000200000000000000000000000000000000000000000000000000000
00020000000200020000200000200000000000000000000000000000000000000000000000000000
00020000000200020000200000200000000000000000000000000000000000000000000000000000
00020000000200020000200000200000000000000000000000000000000000000000000000000000
00022222000222220002220000200000000000000000000000000000000000000000000000000000
00000000000000000000000000000000000000000000000000000000000000000000000000000000
44444444444444444444444444444444444444444444444444444444444444444444444444444444
44444444444444444444444444444444444444444444444444444444444444444444444444444444
44444444444444444444444444444444444444444444444444444444444444444444444444444444
44444444444444444444444444444444444444444444444444444444444444444444444444444444
44444444444444444444444444444444444444444444444444444444444444444444444444444444
00000000000000000000000000000000000000000000000000000000000000000000000000000000
00000000000000000000000000000000000000000000000000000000000000000000000000000000
00000000000000000000000000000000000000000000200020000000000000000000000000000000
00000000000000000000222220000200000220002000200200000000000000000000000000000000
00000000000000000000002000000200000220002000202000000000000000000000000000000000
00000000000000000000002000002020000202002000220000000000000000000000000000000000
00000000000000000000002000020002000200202000220000000000000000000000000000000000
00000000000000000000002000020002000200202000202000000000000000000000000000000000
00000000000000000000002000022222000200202000200200000000000000000000000000000000
00000000000000000000002000020002000200022000200020000000000000000000000000000000
00000000000000000000002000020002000200002000200022000000000000000000000000000000
00000000000000000000000000000000000000000000000000000000000000000000000000000000
11111111111111111111111111111111111111111111111111111111111111111111111111111110
11111111111111111111111111111111111111111111111111111111111111111111111111111110
11111111111111111111111111111111111111111111111111111111111111111111111111111110
00000000000000000000000000000000000000000000000000000000000000000000000000000000
00000000000000000000000000000000000000000000000000000000000000000000000000000000
00000000000000000000000000000000000000000000000000000000000000000000000000000000
00000000000000000000000000000000000000000000000000000000000000000000000000000000
00000000000000000000000000000000000000000000000000000000000000000000000000000000
00000000000000000000000000000000000000222222200000000000000000000000000000000000
00000000000000000000000000000000000000222222200000000000000000000000000000000000
00000000000000000000000000000000000000222222200000000000000000000000000000000000
00000000000000000000000000000000000000222222200000000000000000000000000000000000
00000000000000000000000000000000000000222222200000000000000000000000000000000000
