00000000000000000000000000000000000000000000000000000000000000000000000000000000
00000000000000000000000000000000000000000000000000000000000000000000000000000000
00000000000000000000000000000000000000000000000000000000000000000000000000000000
00000000000000000000000000000000000000000000000000000000000000000000000000000000
00000000000000000000000000000000000000000000000000000000000000000000000000000000
00000000000000000000000022222200000000000000000000000000000000000000000000000000
00000000000000000000000022222200000000002222222000000022222222222000000000000000
00000000000000000000000022222200000000002222222000000022222222222000000222200000
00000000000000000000000022222200000000002222222000000022222222222000000222200000
00000000000000000000000022222200000000002222222000000022222222222000000222200000
00000000000000000000000022222200000000002222222000000022222222222000000222200000
00000000000000000000000022222200000000002222222000000022222222222000000222200000
00000000000000000000000022222200000000002222222000000022222222222000000222200000
00000000000000000000000022222200000000002222222000000022222222222000000222200000
00000000000000000000000022222200000000002222222000000022222222222000000222200000
00000000000000000000000022222200000000002222222000000022222222222000000222200000
00000000000000000000000022222200000000002222222000000022222222222000000222200000
00000000000000000000000022222200000000002222222000000022222222222000000222200000
00000000000004444444444444444444444444444444444444444444444444444444444444444400
01111111111114444444444444444444444444444444444444444444444444444444444444444400
01111111111114444444444444444444444444444444444444444444444444444444444444444400
01111111111114444444444444444444444444444444444444444444444444444444444444444400
01111111111114444444444444444444444444444444444444444444444444444444444444444400
00000000000000000000000022222200000000002222222000000022222222222000000222200000
00000000000000000000000022222200000000002222222000000022222222222000000222200000
00000000000000000000000022222200000000002222222000000022222222222000000222200000
00000000000000000000000022222200000000002222222000000022222222222000000222200000
00000000000000000000000022222200000000002222222000000022222222222000000222200000
00000000000000000000000022222200000000002222222000000022222222222000000222200000
00000000000000000000000022222200000000002222222000000022222222222000000222200000
00000000000000000000000022222200000000002222222000000022222222222000000222200000
00000000000000000000000000000000000000002222222000000000000000000000000222200000
00000000000000000000000000000000000000002222222000000000000000000000000222200000
00000000000000000000000000000000000000000000000000000000000000000000000222200000
00000000000000000000000000000000000000000000000000000000000000000000000222200000
00000000000000000000000000000000000000000000000000000000000000000000000222200000
00000000000000000000000000000000000000000000000000000000000000000000000000000000
00000000000000000000000000000000000000000000000000000000000000000000000000000000
00000000000000000000000000000000000000000000000000000000000000000000000000000000
00000000000000000000000000000000000000000000000000000000000000000000000000000000
00000000000000000000000000000000000000000000000000000000000000000000000000000000
00000000000000000000000000000000000000000000000000000000000000000000000000000000
00000000000000000000000000000000000000000000000000000000000000000000000000000000
00000000000000000000000000000000000000000000000000000000000000000000000000000000
00000000000000000000000000000000000000000000000000000000000000000000000000000000
00000000000000000000000000000000000000000000000000000000000000000000000000000000
00000000000000000000000000000000000000033333000000000000000000000000000000000000
00000000000000000000000000000000000000033333000000000000000000000000000000000000
00000000000000000000000000000000000000033333000000000000000000000000000000000000
00000000000000000000000000000000000000033333000000000000000000000000000000000000
