00000000000000000000000000000000000000000000000000000000000000000000000000000000
00000000000000000000000000000000000000000000000000000000000000000000000000000000
00000000000000000000000000000000000000000000000000000000000000000000000000000000
00000000000000000000000000000000000000000000000000000000000000000000000000000000
00000000000000000000000000000000000000000000000000000000000000000000000000000000
00000000000000000000000000000000000000044444400000000000000000000000000000000000
00000000000000000000000000000000000000044444400000000000000000000000000000000000
00000000000000000000004444444444000000044444400000000000000000000044444444400000
44400000000000000000004444444444000000044444400000000000000000000044444444400000
44400000000000000000004444444444000000044444400000000000000000000044444444400000
44400000000000000000004444444444000000044444400000000000000000000044444444400000
00000000444444000000000000000000000000000000000444444444444440000000000000000000
00000000444444000000000000000000000000000000000444444444444440000000000000000000
40000000444444000000000000000000000000000000000444444444444440000000000000000000
40000000000000000000000000000000000000000000000444444444444440000000000000000000
44444400000000000004444444444400000000000000000444444444444440000000000000000000
44444400004400000004444444444400000000000000000444444444444440000000000000004400
44444400004400000004444444444400044444000000000444444444444440000004400000004400
44444400000000000004444444444400044444000000000000000000000000000004400000004400
00000000000000000004444444444400044444000000000000000000000000000004400000004400
00000000000444000004444444444400044444000000000000000000000000000000000000004400
00044444400444000004444444444400000000000000000000000000000000000000000000000000
00044444400444000000000000000000000000004440000000000000000000000000000004444000
00044444400000000000440000000000000000004440000000044000000000000000000004444000
00044444400000000000440000000000000000000000000000044000000000444444000004444000
00044444400000000000000000000000000000000000000000000000000000444444000000000000
00000000000000000000000000000000000400000000000000000000000000444444000000000000
00000000000044000000000000000000000400000000000000000000000000444444000000000000
00000000000044004444444444444400000400000000000000000000000000000000000000000000
00000004440044004444444444444400000000000444444444444440000000000000000044440000
00444404440000004444444444444400000000000444444444444440000000000000000044440000
00444404440000004444444444444400000440000444444444444440000000440000000044440000
00444400000000004444444444444400000440000444444444444440000000440000000044440000
00000000000000004444444444444400000000000444444444444440000000440000000044440000
00000000000000000000000000000000000000000444444444444440000000000000000044440000
00000000000000000000000000000000000000000000000000000000000000000000000000000000
00000000000000000000000000000440000000000000000000000000000000000000000000000000
00000000000000000000000000000440000000000000000000000000000000000000000000000000
00000000044444444444444444400440000000000000000000000000000000000000000000000000
00000000044444444444444444400000000444444444444444444444444444444440000000444000
00000000044444444444444444400000000444444444444444444444444444444440000000444000
00000000044444444444444444400000000444444444444444444444444444444440000000444000
00000000000000000000000000000000000444444444444444444444444444444440000000444000
00000000000000000000000000000000000000000000000000000000000000000000000000000000
04444444400000000000000000000000000000000000000000000000004444440000000000000000
04444444400000000004444400000000000000000000000000000000004444440000000000000000
04444444400000000004444400000000000000000000000000000000004444440000000000000000
00000000000000000004444400000000000000000000000000000000000000000000000000000000
00000000000000000004444400000000000000000000000000000000000000000000000000000000
00000000000000000000000000000000000000000000000000000000000000000000000000000000
