00000000000000000000000000000000000000000000000000000000000000000000000000000000
00000000000000000000000000000000000000000000000000000000000000000000000000000000
00000000000000000000000000000000000000000000000000000000000000000000000000000000
00000000000022000022200000000000002222000000000000000010002220000000444440000000
00000000000022000022200000000000002222000000000000000010002220000000444440000000
00002222200022000022200000000000002222000000022000000010002220000000444440000000
00002222200022000022200000000000002222000000022000000010002220000000444440000000
00002222200022000022200000000000002222000000022000000010002220000000444440000000
00002222200022000022200000000000002222000000022000000010002220000000444440000000
00002222200022000022200000000000002222000000022000000010002220000000444440000000
00002222200000000022200000000000002222000000022000000010002220000000444440000000
00002222200000000022200000000000002222000000022000000010002220000000444440022200
00002222200000000022200002222200002222000000022000000010002220000000444440022200
00002222200000000022200002222200002222000000022000000010002220000000444440022200
00002222200000000022200002222200002222000000022000000010002220000000444440022200
00002222200000000022200002222200002222000000022000000010002220000000444440022200
00002222200000000022200002222200002222000000022000000010002220000000444440022200
00002222200000000000000002222200002222000000022000000010002220000000444440022200
00002222200000000000000002222200002222000000022000000010002220000000444440022200
00002222200000000000000002222200000000000000022000000010002220000000444440022200
00002222200000000000000002222200000000000000022000000010002220000000444440022200
00002222200000000000000002222200000000000000022000000010002220000000444440022200
00002222200000000000000002222200000111111111122111111111112221111111444440022200
00002222200000000000000002222200000111000000022000000000002220000000444440022200
00002222200002222200000002222200000000000000022000000000002220000000444440022200
00002222200002222200000002222200000000002222222222222222222222200000444440022200
00002222200002222200000002222200000000002222222222222222222222200000444440022200
00002222200002222200000000000000000000002222222222222222222222200000444440022200
00002222200002222200000000000000000000002222222222222222222222200000444440022200
00002222200002222200000000000000000000000000022000000000002220000000444440022200
00000000000002222200000000000000000000000000022000000000002220000000444440022200
00000000000002222200000000000000000000000000022000000000002220000000000000022200
00000000000002222200000000000000022222000000022000000000002220000000000000022200
00000000000002222200000000000000022222000000022000000000002220000044440000022200
00000000000000000000000002222000022222000000022000000000002220000044440000022200
22200000000000000000000002222000022222000000022000111100002220000044440000022200
22200000000000000000000002222000022222000000022000111100002220000044440000022200
22200000000000000000000002222000022222000000022000111100002220000044440000022200
22222222222222222222220002222000022222000000022000111100002220000044440000022200
22222222222222222222220002222000022222000000022000111100002220000044440000022200
22222222222222222222220002222000022222000000022000111100002220000044440000022200
22222222222222222222220002222000022222000000022000111100002220000044440000022200
22200000000000000000000002222000000000000000022000111100002220000044440000022200
22200000000000000000000002222000000000000000022000111100002220000044440000000000
22200000000000000000000002222000000000000000022000111100002220000044440000000000
22200000000000000000000002222000000000000000022000111100002220000044440000000000
22200002222000000000000002222000000000033333022000000000002220000044440000000000
22200002222000000000000002222000000000033333022000000000002220000000000000000000
22200000000000000000000002222000000000033333022000000000002220000000000000000000
22200000000000000000000002222000000000033333022000000000002220000000000000000000
